rectangle
####  #### # # ##  ##  ###### #      ###### #  ###
# ### # ## # # ####  ## #  # #####    ###      ###
 #### ### ## #####              ## ##  # #    ## #
# ### #  #   # ## #  # ## # #   ##   # #  ## # # #
       #####  #####    # # ###### # # ##     #    
### ##   # ## #  ##  ### ###### #  #   #   # #    
 # # # #      ##  #### # ##  ##  ######  #  ### # 
#  # # #   ##  #### ##   # #  ### ###  # # #######
#### ## ####    #####    #  ##  #      #   #### ##
###  ## ##  #   # ## #### ### # #####     # # ##  
 #  #  # #   ###    ## #  #  # ######   ###  # # #
#    #   ###  # #########  # # # #   ## #  ##  ###
##  # #    ## #### ##   #   ##  ## #  #####    # #
 ####### #  # # # ## #   ##       #      ## #   ##
##  ## ## #### #  ##  ##   ##    #####   # # ##   
   ##   # #  #  # # ## #   #      #     ## # # #  
### ###   #    # ## ##       ### # ##  # #     # #
##   # #  #   #    ## # # ##      ## #### #   ##  
#  ## #####  # ##    #   ###  # ####  #   ## ## # 
    ## #   # ##  #### # #       #     ##### #   ##
########## ## ### #   #  #     # #  ## ####  #    
##   ####     ####      ## #####  ## ##      # #  
 #   #       # # #  ##### # #  # #      #    ###  
 # ##   ## #  ###   ##   #  ##  ##  # ##    ###   
  #    ##   #####    # #    ## #   # ##       # # 
 # #  #  #   # #  ### # # ###    ## ## ## ## #### 
   ####   #  #   #  ##      #   #  # ###### #   ##
#####  ####      # ###    ### ### #     ##    #   
 ##    ##     #  ###### ### # # #    ###    ### ##
   ###  #   #  #  ## # ## ##      ## #  ## ## #  #
    #  ##  #### ## ## # ##   ####  #   #    #  ## 
 #    #    #####  #    ### # #   #  #  #  #    ###
  # #      # #   ## ## # # # ## #    ### #   # #  
 #  # #    ### ### #  ###     #        # ###  ## #
 ##     ##  #    # # # # #  # ####   #   ## #### #
####  ####  # ###  ##  ### #  #### ##      ##  #  
 #         #  #  # ##       # #### #  ## #    ####
    ####     #  #   #   ##    # ####   ## #   ## #
     ##  #    ###    #  ###   # #### ##   ###  # #
 ##     # #  #       ###   #  # ## ## # # ## # # #
#  # #      ####   # # #     ###  ###  #     ##  #
#     ## # ##  ##   #  ##  ##      # #     ## # # 
 ##   ##   ## # # #######  #  ##    ####### ## ## 
#  ######   # # #### ###### #  # #### # ######    
 #  # #     #     # #    #    #  ##   # # #  #  ##
##   ##    ##  ### ### # ##### ####     ##  ####  
 # ### ### #  #     ## ## ##  ### ### # ##   #    
 # ######  ##### # # ##        # # ####    ## ####
# #    #  # #  #  ####   ##### #  #   # ## ###    
 # ##   # #### #  # # # #   ##  #  ##    ##### # #
